S  L ------------------------------  M S
SBBBB  TTT        S M           BBBBBBBS
S    BGBBBBB T    S      TBBBBBBBBB    S
S         BBBSSS  S  SSSBBB            S
S              S  S  S                 S
S              S  S  S   T  T-------   S
S     T   R    S  S  S   T  S          S
S     S   RR   S  S  S   T  S   R      S
S     S        S--S--S   T  S  RR    T S
S     S        S  S  S      S          S
S     S        S  S  S  T   S          S
S     S  T  T  S  S  S      S     T T  S
SBBBBBBBGBBBBBBB  S  BBBBBB S   BBBBB BS
S     BBGBBB      S       BBBBBBBBB    S
S         BBBSSS  S  SSSBBB            S
S T T T T      S  S  S   T T T T T T   S
SBBBBBBBBBBBBBBB  S  BBBBBBBBBBBBBBBBBBS
S                 S                    S
S TTT             S     M          TTT S
RRRRRRRRRRRRRRRRRRRRRRRRRRRRRRRRRRRRRRRR
