  s               S------ s     s   Ls  
  s  R   T T T T  S R M   sT  T sR   s  
  s  RBBBBBBBBBBBBSRRRRBRRRRRRRRRR   s  
  s               S                  s  
  s s sRs      M  S          sBs s s s  
   s s RRRRRSRRRRRSBBBBSBBBBBBB s s s   
     s      T     S    T        s       
     Rs TT        S       TT   sR       
     RRRRRRRRRRRRRSRRRRRRRRRRRRRR       
                  S                     
                  S                     
         BBBBBBBBBSBBBBBBBBBB           
        T T       S        T T          
      RRRRRRR     S        RRR          
                  S                     
      ------------S-------------------  
                  S          T          
   M M M          S                     
BBBBBBBBBBBBBBBBBBBBBBBBBBBBBBBBBBBBBBBB
RRRRRRRRRRRRRRRRRRRRRRRRRRRRRRRRRRRRRRRR
