 -------------------------------------- 
S                                      S
S  T   T  TTTTT  T      T       TTT    S
S  T   T  T      T      T      T   T   S
S  TTTTT  TTT    T      T      T   T   S
S  T   T  T      T      T      T   T   S
S  T   T  TTTTT  TTTTT  TTTTT   TTT    S
S                                      S
S--------------------------------------S
S L                                 M  S
SBBBBBS                          SBBBBBS
SB BBBBBBS                     BBSBB  BS
SB      BBBBS             SBBBBBBB    BS
SB          S             S           BS
SB      SBBBSBBB T    T BBBBBBS       BS
SB  BBBBB   BBBBBBBBBBBBBBB   BBBBBB  BS
SB            B           B           BS
SBTT               M                TTBS
BBBBBBBBBBBBBBBBBBBBBBBBBBBBBBBBBBBBBBBB
RRRRRRRRRRRRRRRRRRRRRRRRRRRRRRRRRRRRRRRR
