s     s                        s       s
s     s           M            s       s
s     s                        s       s
s     S------------------------S       s
s     S                        S       s
s     S   BBBBB         BBBBB  S       s
s-----S------------------------S----S--s
s              s     S              S  s
s   BBBBsB     s     S              S  s
s   B TTsB     s     SBBBBBBRRRR    S  s
s   BBBBBB     s   --S      RRRR    S  s
s        RRRRBBBBBB  S----       SSSS  s
s        RRRR        S    BBBBBBBS  T  s
s                    s           S  T  s
s    S----------     s --------  SSSS  s
s  BBSBBM R   BBBBRRRBBBB s  BBBBB  S  s
s    S  RRR               s         S  s
s    S                    s         S  s
sL   S                    s         S  s
RRRRRRRRRRRRRRRRRRRRRRRRRRRRRRRRRRRRRRRR
