s     s                        s       s
s     s                        s       s
s     s                        s       s
s     S------------------------S       s
s     S     T             T    S       s
s     S   BBBBB    T    BBBBB  S       s
s-----S------------------------S----S--s
s              s     S   T  T       S  s
s   BBBBBB T T s  T  S TTMTT        S  s
s   B TT B T T s     SBBBBBBRRRR  M S  s
s   BBBBBB  M  s   --S      RRRR    S  s
s        RRRRBBBBBB  S----T MT T SSSS  s
s        RRRR        S    BBBBBBBS  T  s
s                 T  s T         S  T  s
s    S----------     s --------  SSSS  s
s  BBSBBM R   BBBBRRRBBBB s  BBBBB  S  s
s    S  RRR               s         S  s
s    S                    s         S  s
sL   S                    s         S  s
RRRRRRRRRRRRRRRRRRRRRRRRRRRRRRRRRRRRRRRR
